
// Weapons
ZNULLWEAPON		"*Z Null Weapon*"
ZNULLMINE		"*Blip*"
Nuke2			"Nuke2"
Nuke			"Nuke"
ReactorBurn		"ReactorBurn"
WepMine8		"Omega Mine"
WepMine7		"EMP Mine"
WepMine6		"Plasmite Mine"
WepMine5		"Hvy Anti Tank Mine"
WepMine4		"Shrapnel Mine"
WepMine3		"Incendiary Mine"
WepMine2		"Anti Tank Mine"
WepMine1		"Light Mine"
Cyborg_RocketMine	"Cyborg Mine Sweeper"
TUTMG			"*Light Machine Gun*"
Superweapon2		"*Alex's Super Weapon*"
Superweapon		"*Kev's Super Weapon*"
SpyTurret01		"Nexus Link Turret"
RocketSuper		"*Fortress Rockets*"
Rocket-VTOL-Pod		"VTOL Mini-Pod Rockets"
Rocket-VTOL-LtA-T		"VTOL Lancer"
Rocket-VTOL-HvyA-T		"VTOL Tank Killer"
Rocket-VTOL-BB		"VTOL Bunker Buster"
Rocket-Pod		"Pod Rockets"
Rocket-MRL		"Pod Rockets Artillery"
Rocket-LtA-T		"Lancer"
Rocket-IDF		"Ripple Rocket Artillery"
Rocket-HvyA-T		"Tank Killer"
Rocket-BB		"Bunker Buster"
RailGun4Mk1		"Heavy Gauss Cannon"
RailGun3Mk1		"Gauss Cannon"
RailGun2Mk1		"Rail Gun"
RailGun2-VTOL		"VTOL Rail Gun"
RailGun1Mk1		"Needle Gun"
RailGun1-VTOL		"VTOL Needle Gun"
QuadRotAAGun		"Whirlwind AA Turret"
QuadMg1AAGun		"Hurricane AA Turret"
PlasmiteFlamer		"Plasmite Flamer"
PlasmaHeavy		"Plasma Artillery"
NX-CyborgPulseLas		"*NEXUS Pulse Laser Cyborg*"
NX-CyborgMiss		"*NEXUS Scourge Cyborg*"
NX-CyborgChaingun		"*NEXUS Assault Gunner*"
NX-Cyb-Rail1		"*NEXUS Rail Gunner*"
NEXUSlink		"*NEXUS Link Turret*"
MortarEMP		"EMP Mortar"
Mortar3ROTARYMk1		"Pepperpot"
Mortar2Mk1		"Bombard"
Mortar1Mk1		"Mortar"
Mortar-Incenediary		"Super Twin Cannon"
MissileSuper		"*Fortress Missiles*"
Missile-VTOL-AT		"VTOL Scourge Missile"
Missile-MdArt		"Condor Missile Artillery"
Missile-LtSAM		"Avenger SAM"
Missile-HvySAM		"Vindicator SAM"
Missile-HvyArt		"Archangel Missile Artillery"
Missile-A-T		"Scourge Missile"
MG5TWINROTARY		"Twin Assault Gun"
MG4ROTARYMk1		"Assault Gun"
MG4ROTARY-VTOL		"VTOL Assault Gun"
MG4ROTARY-Pillbox		"Rotary MG Bunker"
MG3Mk1		"Heavy Machinegun"
MG3-VTOL		"VTOL Heavy Machinegun"
MG3-Pillbox		"Heavy Machinegun Bunker"
MG2Mk1		"Twin Machinegun"
MG2-VTOL		"VTOL Twin Machinegun"
MG2-Pillbox		"*Twin Machinegun Bunker*"
MG1Mk1		"Machinegun"
MG1-VTOL		"VTOL Machinegun"
MG1-Pillbox		"MG Bunker"
MassDriver		"*Fortress Mass Driver*"
LasSat		"Mini Nuclear Missile Silo"
Laser4-PlasmaCannon		"Plasma Cannon"
Laser3BEAMMk1		"Light Pulse Laser"
Laser3BEAM-VTOL		"VTOL Flashlight"
Laser2PULSEMk1		"Twin Pulse Laser"
Laser2PULSE-VTOL		"VTOL Pulse Laser"
Howitzer150Mk1		"Ground Shaker Artillery"
Howitzer105Mk1		"Howitzer Artillery"
Howitzer03-Rot		"Hellstorm Artillery"
Howitzer-Incenediary		"Incendiary Howitzer Artillery"
HeavyLaser-VTOL		"VTOL Heavy Laser"
HeavyLaser		"Heavy Pulse Laser"
Flame2		"Inferno"
Flame1Mk1		"Flamer"
EMP-Cannon		"EMP Cannon"
CyborgRotMG		"*Cyborg Assault MG*"
CyborgRocket		"Pod Rockets Cyborg"
CyborgFlamer01		"*Cyborg Flamer*"
CyborgChaingun		"*Cyborg MG*"
CyborgCannon		"*Cyborg Light Cannon*"
Cyb-Wpn-Thermite		"*Cyborg Thermite Flamer*"
Cyb-Wpn-Rail1		"*Cyborg Needle Gun*"
Cyb-Wpn-Laser		"*Cyborg Flashlight Laser*"
Cyb-Wpn-Grenade		"Cyborg Plasma Sniper"
Cyb-Wpn-Atmiss		"Cyborg Lancer"
Cyb-Hvywpn-TK		"*Cyborg Tank-Killer*"
Cyb-Hvywpn-RailGunner		"*Cyborg Rail Gun*"
Cyb-Hvywpn-PulseLsr		"*Cyborg Pulse Laser*"
Cyb-Hvywpn-Mcannon		"*Cyborg Medium Cannon*"
Cyb-Hvywpn-HPV		"Cyborg Grenadier"
Cyb-Hvywpn-Acannon		"*Cyborg Assault Cannon*"
Cyb-Hvywpn-A-T		"*Cyborg Scourge (super) *"
CommandTurret1		"Command Turret"
CannonSuper		"*Fortress Cannon*"
Cannon6TwinAslt		"Twin Assault Cannon"
Cannon5VulcanMk1		"Assault Cannon"
Cannon5Vulcan-VTOL		"VTOL Assault Cannon"
Cannon4AUTOMk1		"Twin Heavy Cannon"
Cannon4AUTO-VTOL		"VTOL HPV Cannon"
Cannon375mmMk1		"Heavy Cannon"
Cannon2A-TMk1		"Medium Cannon"
Cannon1Mk1		"Light Cannon"
Cannon1-VTOL		"VTOL Cannon"
BusCannon		"*Scav Cannon*"
BuggyMG		"*Scav Buggy MG*"
bTrikeMG		"*Scav Trike MG*"
BTowerMG		"*Scav MG Tower*"
Bomb6-VTOL-EMP		"EMP Missile Launcher"
Bomb5-VTOL-Plasmite		"VTOL Plasmite Bombs"
Bomb4-VTOL-HvyINC		"VTOL Thermite Bombs"
Bomb3-VTOL-LtINC		"VTOL Phosphor Bombs"
Bomb2-VTOL-HvHE		"VTOL HEAP Bombs"
Bomb1-VTOL-LtHE		"VTOL Cluster Bobms"
BJeepMG		"*Scav Jeep Mg*"
BabaRocket		"*Scav Mini Rockets*"
BabaPitRocketAT		"*Scav AT Rocket Site*"
BabaPitRocket		"*Scav AT Rocket*"
BaBaMG		"*Scav Infantry MG*"
BabaFlame		"*Scav Flamer Tower*"
BaBaCannon		"*Scav Cannon Bunker*"
AAGunLaser		"Hyper Fire Laser"
AAGun2Mk1		"Cyclone Flak Turret"
AAGunLaserVTOL		"VTOL Tank Killer Laser"
scv-Hvywpn-HPV		"Scavenger Grenadier"
EMP-Trap		"EMP Tank Traps"
AAS-weapon			"Anti Aircraft Shield-Weapon"
GS-weapon		"Anti Ground Shield-Weapon"
LasSat2			"Laser Satellite"
Incenediary-Mo		"Incendiary Mortar"
MG3HERO 		"Commander MG"

// Commander systems
ZNULLBRAIN		"*Z NULL BRAIN*"
CommandBrain01		"Command Turret"

// Sensors & ECM's
ZNULLSENSOR		"Z NULL SENSOR"
ZNULLSENSOR2	"Z NULL SENSOR2"
UplinkSensor		"Uplink Sensor"
Sys-VTOLRadarTower01		"VTOL Strike Tower"
Sys-VTOLCBTurret01		"VTOL CB Radar Turret"
Sys-VTOLCBTower01		"VTOL CB Radar Tower"
Sys-VstrikeTurret01		"VTOL Strike Turret"
Sys-NXLinkTurret01		"NEXUS Link"
Sys-CBTurret01		"CB Radar Turret"
Sys-CBTower01		"*CB Tower*"
SensorTurret1Mk1		"Sensor Turret"
SensorTower2Mk1		"Hardened Sensor Tower"
Sensor-WideSpec		"Wide Spectrum Sensor"
NavGunSensor		"*NavGunSensor*"
DefaultSensor1Mk1		"*Default Sensor1 Mk1*"
CCSensor		"*CC Sensor*"
BaBaSensor		"*BaBa Default Sensor*"
ZNULLECM		"Z NULL ECM"
RepairCentre		"*RepairCenter*"

// Trucks & Repair Turrets
CyborgSpade2		"*Cyborg Minelayer*"
ZNULLCONSTRUCT		"Z NULL CONSTRUCT"
Spade1Mk1		"Truck"
CyborgSpade		"*Combat Engineer*"
ZNULLREPAIR		"Z NULL REPAIR"
NEXUSrepair		"*NEXUSrepair*"
LightRepair1		"Mobile Repair Turret"
HeavyRepair		"Heavy Repair Turret"
CyborgRepair		"*Cyborg Mechanic*"
AutoRepair		"*AutoRepair*"
BaBaSpade		"Scavenger Builder"

// Chassis types
ZNULLBODY		"*Z NULL BODY*"
Cyb-Bod-MineSweep	"Minesweeper Cyborg"
Cyb-Bod-ComEng2		"Minelayer Cyborg"
TransporterBody		"Transport Body"
Superbody		"*Kev's Super Body*"
FireBody		"Scavenger Fire Car"
CybRotMgGrd		"*Cyborg Assault Gun*"
CyborgRkt1Ground		"CyborgRocket1Ground*"
CyborgFlamerGrd		"*Cyborg Flamer*"
CyborgChn1CCGround		"*Cyborg Machine Gun*"
CyborgChain1Ground		"*CyborgChaingun1Ground*"
CyborgCannonGrd		"*Cyborg Cannon*"
CyborgCan1CGround		"*Cyborg Cannon*"
CybNXRail1Jmp		"*CybNXRail1Jmp*"
CybNXPulseLasJmp		"*CybNXPulseLasJ*"
CybNXMissJmp		"*CybNXMissJmp*"
CybFlamer01CGrd		"*Cyborg Flamer*"
Cyb-Hvybod-TK		"Super Tank-Killer Cyborg"
Cyb-Hvybod-RailGunner		"Super Rail-Gunner"
Cyb-Hvybod-PulseLsr		"Super Pulse Laser Cyborg"
Cyb-Hvybod-Mcannon		"Super Heavy-Gunner"
Cyb-Hvybod-HPV		"Cyborg Grenadier"
Cyb-Hvybod-Acannon		"Super Assault Cannon Cyborg"
Cyb-Hvybod-A-T		"Super Scourge Cyborg"
Cyb-Bod-Thermite		"*Thermite Body*"
Cyb-Bod-Rail1		"*Cyb-Bod-Rail1*"
Cyb-Bod-Mechanic		"*Cyborg Mechanic*"
Cyb-Bod-Las1		"*Cyb-Bod-Las1*"
Cyb-Bod-Grenade		"*Grenadier Body*"
Cyb-Bod-ComEng		"*Combat Engineer*"
Cyb-Bod-Atmiss		"*Cyb-Bod-Atmiss*"
BusBody			"Scavenger School Bus"
Body1REC		"Light Body Viper (US)"
Body5REC		"Medium Body Cobra (US)"
Body11ABT		"Heavy Body Python (US)"
Body4ABT		"Light Body Bug (CU)"
Body8MBT		"Medium Body Scorpion (CU)"
Body12SUP		"Heavy Body Mantis (CU)"
Body2SUP		"Light Body Leopard (DE)"
Body6SUPP		"Medium Body Panther (DE)"
Body9REC		"Heavy Body Tiger (DE)"
Body3MBT		"Light Body Retaliation (CA)"
Body7ABT		"Medium Body Retribution (CA)"
Body10MBT		"Heavy Body Vengeance (CA)"
Body13SUP		"Super Heavy Body Wyvern (JP)"
Body14SUP		"Extreme Heavy Body Dragon (CN)"
Body0REC		"Viper"
B4body-sml-trike01		"Trike Body"
B3bodyRKbuggy01		"*Rocket Buggy Body*"
B3body-sml-buggy01		"Buggy Body"
B2RKJeepBody		"*Rocket Jeep Body*"
B2JeepBody		"Jeep Body"
B1BaBaPerson01		"*BaBa Body*"
TruckBody		"Jeep"
SEBody1			"Light Body Fish (ES)"
SEBody2			"Medium Body Dolphin (ES)"
SEBody3			"Heavy Body Whale (ES)"
SABody1			"Light Body Chimpanzee (ET)"
SABody2			"Medium Body Baboon (ET)"
SABody3			"Heavy Body Gorilla (ET)"

// Propulsions
ZNULLPROP		"Z NULL PROP"
wheeled03		"Wheels III"
wheeled02		"Wheels II"
wheeled01		"Wheels"
V-Tol04		"VTOL IV"
V-Tol03		"VTOL III"
V-Tol02		"VTOL II"
V-Tol		"VTOL"
tracked03		"Tracks III"
tracked02		"Tracks II"
tracked01		"Tracks"
hover03		"Hover III"
hover02		"Hover II"
hover01		"Hover"
HalfTrack03		"Half-tracks III"
HalfTrack02		"Half-tracks II"
HalfTrack		"Half-tracks"
CyborgLegs03		"Cyborg Propulsion III"
CyborgLegs02		"Cyborg Propulsion II"
CyborgLegs		"Cyborg Propulsion"
BaBaProp		"BaBaProp"
BaBaLegs		"BaBaLegs"

// Unit Templates
ZNULLDESIGN		"New Design"
Cyb-ComEng2		"Mine Layer Cyborg"
Cyb-MineSweep		"Mine Sweeper Cyborg"
BarbarianTrike		"Scavenger Grenadier (15)"
ConstructionDroid		"W-50 Truck"
BarbarianBuggy		"Buggy"
BaBaPeople		"Light Machinegun Scavenger (4)"
ViperLtCannonWheels		"Viper Light Cannon Wheels"
BabaJeep		"Heavy Machinegun Scavenger (7)"
ConstructorDroid		"W-50 Truck"
ViperLtCannonHTracks	"W-50 Light Cannon Half Tracks"
ViperLtMGWheels		"Machinegun Viper Wheels"
ViperLtCannonTracks		"Viper Light Cannon Tracks"
CyborgChain01CGround		"Machinegunner"
ViperMedCnTrks		"Viper Medium Cannon Tracks"
CobraLtCnTrks		"Cobra Light Cannon Tracks"
CobraMedCnTrks		"Cobra Medium Cannon Tracks"
CobraHvyCnTrks		"Cobra Heavy Cannon Tracks"
PythonLtCnTrks		"Python Light Cannon Tracks"
PythonHvyCnTrks		"Python Heavy Cannon Tracks"
ViperFlameWheels		"Viper Flamer Wheels"
ViperSensorWheels		"Viper Sensor Wheels"
BabaRKJeep		"Rocket Scavenger"
BarbarianRKBuggy		"Pod Rockets Scavenger (12)"
Transporter		"Heavy Machinegun Transporter"
BabaBusCan		"Light Cannon Scavenger (12)"
BabaFireCan		"Scavenger Flamer"
CyborgFlamer01CGrd		"Flamer Cyborg"
CyborgCannon01CGrd		"Cannon Cyborg"
NP-L-RocketPod-Wheels		"*NP-L-RocketPod-Wheels*"
NP-L-MRLS-Halftrack		"*NP-L-MRLS-Half-track*"
NP-L-HMG-Halftrack		"*NP-L-HMG-Half-track*"
NP-L-LtAT-Halftrack		"*NP-L-LtAT-Half-track*"
NP-L-Sensor-Wheels		"*NP-L-Sensor-Wheels*"
NP-M-Command-Halftrack		"*NP-M-Command-Half-track*"
NP-M-Sensor-Wheels		"*NP-M-Sensor-Wheels*"
NP-M-MdCannon-Halftrack		"*NP-M-MdCannon-Half-track*"
NP-M-MdCannon-Tracks		"*NP-M-MdCannon-Tracks*"
NP-M-LtMortar-Halftrack		"*NP-M-LtMortar-Half-track*"
NP-M-HvyMortar-Halftrack		"*NP-M-HvyMortar-Half-track*"
NP-M-BB-Halftrack		"*NP-M-BB-Half-track*"
NP-H-MdCannon-Tracks		"*NP-H-MdCannon-Tracks*"
NP-H-HvyCannon-Tracks		"*NP-H-HvyCannon-Tracks*"
Cyb-Chain-GROUND		"Machinegun Cyborg"
CO-H-How105-Tracks		"*CO-H-How105-Tracks*"
CO-H-How150-Tracks		"*CO-H-How150-Tracks*"
CO-H-HvyCan-Tracks		"*CO-H-HvyCan-Tracks*"
CO-M-MedCan-Tracks		"*CO-M-MedCan-Tracks*"
CO-M-Sensor-T		"*CO-M-Sensor-T*"
CyborgFlamer01Grd		"Flamer Cyborg"
CyborgRkt01Ground		"Lancer Cyborg"
CyborgCannon01Grd		"Cannon Cyborg"
CyborgChain01Ground		"Machinegun Cyborg"
CobraMortarHalfTrack		"Cobra Mortar Half-track"
CobraHMGHalfTrack		"Cobra Heavy Machinegun Half-track"
CO-M-Con-T		"*CO-M-Con-T*"
BabaFireTruck		"Scavenger Flamer (10)"
BabaPickUp		"Pick-Up Truck"
NX-M-Rail2-Hover		"*NX-M-Rail2-Hover*"
NX-L-PulseLas-VTOL		"*NX-L-PulseLas-VTOL*"
NX-L-Missile-A-T-VTOL		"*NX-L-ASMiss-VTOL*"
NX-L-Sens-Hov		"*NX-L-Sens-Hov*"
NX-M-Missile-A-T-Hover		"*NX-M-ATMiss-Hov*"
NX-M-Com-Hover		"*NX-M-Com-Track*"
NX-Cyb-Rail1-JUMP		"*NX-Cyb-JUMP*"
NX-Cyb-PulseLas-JUMP		"*NX-Cyb-PulseLas-JUMP*"
NX-Cyb-Miss-JUMP		"*NX-Cyb-Miss-JUMP*"
SuperTank		"*Kev's Super Tank*"
NP-M-LitCannon-Halftrack		"*NP-M-LtCannon-Half-track*"
NX-M-Con-Hover		"*NX-M-Con-Hover*"
SuperTank2		"*Alex's Killa*"
NX-L-Repair-Hover		"*NX-L-Repair-Hover*"
ATESTVEHICLE		"VTOL Sensor"
NP-M-LtAT-Hover		"*NP-M-LtAT-Hover*"
NP-H-HvyCannon-Hover		"*NP-H-HvyCannon-Hover*"
NP-M-MG3-Hover		"*NP-M-MG3-Hover*"
ATESTVTOL		"VTOL Truck"
ASPOTTER		"VTOL CB Sensor"
NP-M-CON-HalfTrack		"*NP-M-CON-Half-track*"
NP-M-CON-Track		"*NP-M-CON-Track*"
NP-M-Repair-HalfTrack		"*NP-M-Repair-Half-track*"
NP-M-Command-Track		"*NP-M-Command-Track*"
NP-M-CBS-Halftrack		"*NP-M-CBS-Halftrack*"
NP-L-LtCannon-Halftrack		"*NP-L-LtCannon-Halftrack*"
CO-M-Repair-T		"*CO-M-Repair-T*"
CO-M-Vstrike-T		"*CO-M-Vstrike-T*"
CO-M-VTOLCBS-T		"*CO-M-VTOLCBS-T*"
CO-H-Command-Track		"*CO-H-Command-Track*"
CO-M-HMG-T		"*CO-M-HMG-T*"
CO-M-LTAT-Hover		"*CCO-M-LTAT-Hover*"
CO-M-HPVCannon-Tracks		"*CO-M-HPVCannon-Tracks*"
CO-M-Rocket-LtA-T-T		"*CO-M-Rocket-LtA-T-T*"
CO-M-Rocket-HvyA-T-Track		"*CO-M-Rocket-HvyA-T-Track*"
CO-H-RotCan-Track		"*CO-H-RotCan-Track*"
CO-H-HPVCannon-Tracks		"*CO-H-HPVCannon-Tracks*"
CO-H-Rkt-BB-T		"*CO-H-Rkt-BB-T*"
CO-M-HvMortar-T		"*CO-M-HvMortar-T*"
CO-M-RotMortar-T		"*CO-M-RotMortar-T*"
CO-H-RotHow-Track		"*CO-H-RotHow-Track*"
CO-L-Rocket-LtA-T-VTOL		"*CO-L-LtATRkt-VTOL*"
CO-H-COM-H		"*CO-H-COM-H*"
CO-L-RotMG-VTOL		"*CO-L-RotMG-VTOL*"
CO-M-Bomb1-VTOL		"*CO-M-Bomb1-VTOL*"
CO-M-Bomb2-VTOL		"*CO-M-Bomb2-VTOL*"
CO-H-QuadBofAA-T		"*CO-H-QuadBofAA-T*"
CO-H-QuadRotAA-T		"*CO-H-QuadRotAA-T*"
NX-M-Link-Hover		"*NX-M-Link-Hover*"
NX-H-CBS-Hover		"*NX-H-CBS-Hover*"
NX-M-Strike-Hover		"*NX-M-Strike-Hover*"
NX-M-VTOLCBS-Hover		"*NX-M-VTOLCBS-Hover*"
NX-M-PulseLas-Hover		"*NX-M-Laser2-Hover*"
NX-H-Rail3-Hover		"*NX-H-Rail3-Hover*"
NX-L-Flash-Hover		"*NX-L-Flash-Hover*"
NX-L-Missile-MdArt-Hover		"*NX-L-MdMiss-Hover*"
NX-H-HvMiss-Hover		"*NX-H-HvMiss-Hover*"
NX-L-Rail1-VTOL		"*NX-L-Rail1-VTOL*"
NX-H-Rail2-VTOL		"*NX-H-Rail2-VTOL*"
Cyb-Flamer-GROUND		"Flamer Cyborg"
Cyb-Cannon-GROUND		"Cannon Cyborg"
Cyb-Rocket-GROUND		"Lancer Cyborg"
Cyb-RotMG-GROUND		"Assault Gun Cyborg"
BaBaCivilian		"Civilian"
ViperRepairWheels		"Viper Repair Wheels"
ViperRepairHalftrack		"Viper Repair Half-track"
ViperMG01Wheels		"Viper Machine Gun Wheels"
ViperMG02Wheels		"Viper Twin Machinegun Wheels"
ViperMG02Halftrack		"Viper Twin Machinegun Half-track"
ViperHMGHalftrack		"Viper Heavy Machinegun Half-track"
ViperHMGTracks		"Viper Heavy Machinegun Tracks"
ViperLtA-Twheels		"Viper Lancer Wheels"
ViperPODWheels		"Viper Mini-Pod Rockets Wheels"
ViperMRLWheels		"Viper Mini-Rocket Artillery Wheels"
ViperBBWheels		"Viper Bunker Buster Rockets Wheels"
CobraSpadeTracks		"Cobra Truck"
CobraSensorHalftrack		"Cobra Sensor Half-track"
CobraFlameTracks		"Cobra Flamer Tracks"
CobraHvyMortarHalftrack		"Cobra Bombard Half-track"
CobraComHalftrack		"Cobra Command Turret Half-track"
CobraLtA-Thalftrack		"Cobra Lancer Half-track"
CobraMRLHalftrack		"Cobra Mini-Rocket Artillery Half-track"
PythonComTracks		"Python Commander Tracks"
PythonMedCnTrks		"Python Medium Cannon Tracks"
P0PythonHvyCnTrks		"Python Heavy Cannon Tracks"
P0CobraSpadeTracks		"Cobra Truck"
P0CobraFlameTracks		"Cobra Flamer Tracks"
P0CobraMedCnTrks		"Cobra Medium Cannon Tracks"
CO-M-HvFlame-Track		"*CO-M-HvFlame-Track*"
CO-M-RR-HT		"*CO-M-RR-HT*"
CO-M-CBS-T		"*CO-M-CBS-T*"
CO-M-ROTMG-T		"*CO-M-ROTMG-T*"
CO-M-HVAT-V		"*CO-M-HVAT-V*"
P0CobraLtATRktHtrack		"Lancer Cobra Half-tracks"
P0CobraHvyMGHtrack		"HMG Cobra Half-tracks"
P0PythonComTracks		"Commander Python Tracks"
CO-M-HVAT-Hover		"*CCO-M-HVAT-Hover*"
P0CobraRepairTrks		"Repair Cobra Tracks"
CO-L-Bomb1-VTOL		"*CO-L-Bomb1-VTOL*"
Cyb-Atmiss-GROUND		"Super Scourge Cyborg"
Cyb-Laser1-GROUND		"Super Light Pulse Laser Cyborg"
Cyb-Rail1-GROUND		"Super Rail Gun Cyborg"
P6-L-LTAT-V		"*Skirmish ATVTOL*"
P6-L-Bomb1-V		"*Skirmish BOMBVTOL*"
P6-M-QMG1-HT		"*P6-M-QMG1-HT*"
P0cam3CobCONTrk		"Truck"
P0cam3PyHvyATTrk		"Tank Killer Python Tracks"
P0cam3PyHPVcanTrk		"HPV Cannon Python Tracks"
P0cam3PyFlakHT		"Cyclone AA Python Half-tracks"
P0cam3PyAsltGnTrk		"Assault Gun Python Tracks"
NX-M-Bomb4-VTOL		"*NX-M-Bomb4-VTOL*"
NX-M-HvSam-Hover		"*NX-M-HvSam-Hover*"
NX-L-Link-Hov		"*NX-L-Link-Hov*"
NX-M-Bomb2-VTOL		"*NX-M-Bomb2-VTOL*"
CyborgRotMgGround		"Assault Gun Cyborg"
Sk-PythonHvCanTrack		"Python Heavy Cannon Tracks"
Sk-CobraBBHover		"Cobra Bunker Buster Hover"
MP-Cyb-Laser1-GRD		"Super Light Pulse Laser Cyborg"
MP-Cyb-ATmiss-GRD		"Super Scourge Cyborg"
SK-Cobra-Hover-HMG		"*SK-Cobra-Hover-HMG*"
SK-Cobra-Hover-BB		"*SK-Cobra-Hover-BB*"
SK-Cobra-Hover-Lancer		"*SK-Cobra-Hover-Lancer*"
SK-Python-Hover-Mcannon		"*SK-Python-Hover-Mcannon*"
SK-Python-Hover-Hcannon		"*SK-Python-Hover-Hcannon*"
SK-Python-Hover-Lancer		"*SK-Python-Hover-Lancer*"
SK-Python-Track-Hcannon		"*SK-Python-Track-Hcannon*"
SK-Cobra-Track-HVC		"*SK-Cobra-Track-HVC*"
SK-Cobra-Track-TK		"*SK-Cobra-Track-TK*"
SK-Bug-Hover-HMG		"*SK-Bug-Hover-HMG*"
SK-Scorp-Hover-ASGUN		"*SK-Scorp-Hover-ASGUN*"
SK-Scorp-Hover-Mcannon		"*SK-Scorp-Hover-Mcannon*"
SK-Scorp-Hover-Bombard		"*SK-Scorp-Hover-Bombard*"
SK-Scorp-Hover-Lancer		"*SK-Scorp-Hover-Lancer*"
SK-Scorp-Hover-BB		"*SK-Scorp-Hover-BB*"
SK-Mantis-Hover-Hcannon		"*SK-Mantis-Hover-Hcannon*"
SK-Mantis-Hover-HVC		"*SK-Mantis-Hover-HVC*"
SK-Leopard-Track-Lancer		"*SK-Leopard-Track-Lancer*"
SK-Leopard-HTrk-ASGun		"*SK-Leopard-HTrk-ASGun*"
SK-Panther-Track-HVC		"*SK-Panther-Track-HVC*"
SK-Panther-Hover-HVC		"*SK-Panther-Hover-HVC*"
SK-Panther-Track-TK		"*SK-Panther-Track-TK*"
SK-Panther-Hover-TK		"*SK-Panther-Hover-TK*"
SK-Panther-Htrk-ASGun		"*SK-Panther-Htrk-ASGun*"
SK-Panther-Htrk-BB		"*SK-Panther-Htrk-BB*"
SK-Tiger-Track-Hcannon		"*SK-Tiger-Track-Hcannon*"
SK-Tiger-Hover-Hcannon		"*SK-Tiger-Hover-Hcannon*"
SK-Tiger-Track-HVC		"*SK-Tiger-Track-HVC*"
SK-Tiger-Hover-HVC		"*SK-Tiger-Hover-HVC*"
SK-Tiger-Track-TK		"*SK-Tiger-Track-TK*"
SK-Tiger-Hover-TK		"*SK-Tiger-Hover-TK*"
SK-Tiger-Track-ASCannon		"*SK-Tiger-Track-ASCannon*"
SK-Tiger-Hover-ASCannon		"*SK-Tiger-Hover-ASCannon*"
SK-Leopard-Htrk-Needle		"*SK-Leopard-Htrk-Needle*"
SK-Leopard-Hover-Needle		"*SK-Leopard-Hover-Needle*"
SK-Panther-Track-RailGun		"*SK-Panther-Track-RailGun*"
SK-Tiger-Track-Scourge		"*SK-Tiger-Track-Scourge*"
SK-Tiger-Hover-Scourge		"*SK-Tiger-Hover-Scourge*"
SK-Tiger-Track-Gauss		"*SK-Tiger-Track-Gauss*"
SK-Tiger-Hover-Gauss		"*SK-Tiger-Hover-Gauss*"
SK-Retal-Track-Needle		"*SK-Retal-Track-Needle*"
SK-Retre-Track-PulseLsr		"*SK-Retre-Track-PulseLsr*"
SK-Retre-Track-FlashLight		"*SK-Retre-Track-FlashLight*"
SK-Retre-Htrk-Pepper		"*SK-Retre-Htrk-Pepper*"
SK-Retre-Track-RailGun		"*SK-Retre-Track-RailGun*"
SK-Retre-Hover-RailGun		"*SK-Retre-Hover-RailGun*"
SK-Retre-Track-Scourge		"*SK-Retre-Track-Scourge*"
SK-Retre-Hover-Scourge		"*SK-Retre-Hover-Scourge*"
SK-Veng-Track-Gauss		"*SK-Veng-Track-Gauss*"
SK-Veng-Hover-Gauss		"*SK-Veng-Hover-Gauss*"
SK-Veng-Track-PulseLsr		"*SK-Veng-Track-PulseLsr*"
SK-Veng-Hover-PulseLsr		"*SK-Veng-Hover-PulseLsr*"
SK-Veng-Track-Scourge		"*SK-Veng-Track-Scourge*"
SK-Veng-Hover-Scourge		"*SK-Veng-Hover-Scourge*"
SK-Bug-Hover-Sensor		"*SK-Bug-Hover-Sensor*"
SK-Bug-Hover-Repair		"*SK-Bug-Hover-Repair*"
SK-Leopard-Hover-Sensor		"*SK-Leopard-Hover-Sensor*"
SK-Leopard-Hover-Repair		"*SK-Leopard-Hover-Repair*"
SK-Panther-Track-Repair		"*SK-Panther-Track-Repair*"
SK-Retal-Hover-Repair		"*SK-Retal-Hover-Repair*"
SK-Retal-Hover-Sensor		"*SK-Retal-Hover-Sensor*"
SK-Bug-VTOL-CLBomb		"*SK-Bug-VTOL-CLBomb*"
SK-Bug-VTOL-BB		"*SK-Bug-VTOL-BB*"
SK-Scorpion-VTOL-BB		"*SK-Scorpion-VTOL-BB*"
SK-Scorpion-VTOL-Hbomb		"*SK-Scorpion-VTOL-Hbomb*"
SK-Mantis-VTOL-BB		"*SK-Mantis-VTOL-BB*"
SK-Leopard-VTOL-BB		"*SK-Leopard-VTOL-BB*"
SK-Leopard-VTOL-PhosBomb		"*SK-Leopard-VTOL-PhosBomb*"
SK-Panther-VTOL-Thermite		"*SK-Panther-VTOL-Thermite*"
SK-Panther-VTOL-BB		"*SK-Panther-VTOL-BB*"
SK-Panther-VTOL-Phosbomb		"*SK-Panther-VTOL-Phosbomb*"
SK-Panther-VTOL-TK		"*SK-Panther-VTOL-TK*"
SK-Retal-VTOL-Phosbomb		"*SK-Retal-VTOL-Phosbomb*"
SK-Retre-VTOL-Thermite		"*SK-Retre-VTOL-Thermite*"
SK-Retre-VTOL-PulseLsr		"*SK-Retre-VTOL-PulseLsr*"
SK-Retre-VTOL-Scourge		"*SK-Retre-VTOL-Scourge*"
MP-Cyb-Needle-GRD		"Super Rail Gun Cyborg"
Cyb-Thermite		"Thermite Flame Cyborg"
Cyb-Gren		"Plasma Sniper Mech"
Cyb-ComEng		"Combat Engineer Cyborg"
Cyb-Mechanic		"Mechanic Cyborg"
Cyb-Hvy-Mcannon		"Super Cannon Cyborg"
Cyb-Hvy-Acannon		"Super Assault Cannon Cyborg"
Cyb-Hvy-PulseLsr		"Heavy Pulse Laser Mech"
Cyb-Hvy-TK		"Super Tank Killer Cyborg"
Cyb-Hvy-HPV		"Grenadier Cyborg"
Cyb-Hvy-RailGunner		"Heavy Gauss Gun Mech"
Cyb-Hvy-A-T		"Scourge Mech"
SK-Veng-Track-C6TwinAslt		"*SK-Veng-Track-C6TwinAslt*"
SK-Veng-Track-HvyLaser		"*SK-Veng-Track-HvyLaser*"
W50Mg			"W-50 Wheels Machinegun"
W50TwinMg		"W-50 Wheels Twin Machinegun"
BaBaPeople2 	"John Hammond"
BaBaPeople3	"Research Truck"

// Research
R-Vehicle-Truck		"W-50"
R-Struc-AAShield		"Anti Aircraft Shield"
R-Vehicle-SEBody1		"Spanish - Light Body - Fish"
R-Vehicle-SEBody2		"Spanish - Medium Body - Dolphin"
R-Vehicle-SEBody3		"Spanish - Heavy Body - Whale"
R-Vehicle-SABody1		"Ethiopian - Light Body - Chimpanzee"
R-Vehicle-SABody2		"Ethiopian - Medium Body - Baboon"
R-Vehicle-SABody3		"Ethiopian - Heavy Body - Gorilla"
R-Struc-com		"Command Center"
R-Defense-Mine1		"Light Contact Mine"
R-Defense-Mine2		"Anti-Tank Contact Mine"
R-Defense-Mine3		"Incendiary Contact Mine"
R-Defense-Mine4		"Shrapnel Contact Mine"
R-Defense-Mine5		"Heavy Anti-Tank Mine"
R-Defense-Mine6		"Plasmite Contact Mine"
R-Defense-Mine7		"EMP Contact Mine"
R-Defense-Mine8		"Omega Contact Mine"
R-Cyb-MineSwp		"Mine Sweeper Cyborg"
R-Cyb-Miner		"Mine Layer Cyborg"
R-Cyborg-Wpn-Thermite		"Thermite Flame Cyborg"
R-Cyborg-Wpn-Grenade		"Plasma Sniper Cyborg"
R-Cyborg-Sys-ComEng		"Combat Engineer Cyborg"
R-Cyborg-Sys-Mechanic		"Mechanic Cyborg"
R-Wpn-Howitzer-Incenediary		"Incendiary Howitzer Artillery"
R-Defense-Howitzer-Incenediary		"Incendiary Howitzer Artillery Site"
R-Wpn-Plasmite-Flamer		"Plasmite Flamer"
R-Defense-PlasmiteFlamer		"Plasmite Flamer Bunker"
R-Wpn-Mortar-Incenediary		"Super Twin Cannon"
R-Defense-MortarPit-Incenediary		"Super Twin Cannon Bunker"
R-Cyborg-Transport		"Heavy Machinegun Transporter"
R-Cyborg-Armor-Heat07		"Cyborg Superdense Thermal Armor"
R-Cyborg-Armor-Heat08		"Cyborg Superdense Thermal Armor Mk2"
R-Cyborg-Armor-Heat09		"Cyborg Superdense Thermal Armor Mk3"
R-Vehicle-Armor-Heat07		"Vehicle Superdense Thermal Armor"
R-Vehicle-Armor-Heat08		"Vehicle Superdense Thermal Armor Mk2"
R-Vehicle-Armor-Heat09		"Vehicle Superdense Thermal Armor Mk3"
R-Sys-MobileRepairTurretHvy		"Heavy Repair Turret"
R-Vehicle-Prop-Tracks		"Tracked Propulsion"
R-Vehicle-Prop-Tracks02	"Tracked Propulsion2"
R-Vehicle-Prop-Hover		"Hover Propulsion"
R-Vehicle-Prop-Hover02	"Hover Propulsion2"
R-Struc-Research-Module		"Research Module"
R-Wpn-Rocket05-MiniPod		"Pod Rockets"
R-Wpn-Rocket01-LtAT		"Lancer AT Rocket"
R-Defense-HardcreteWall		"Hardcrete"
R-Wpn-Cannon1Mk1		"Light Cannon"
R-Struc-Factory-Module		"Factory Module"
R-Wpn-MG1Mk1		"Machinegun"
R-Wpn-MG2Mk1		"Twin Machinegun"
R-Wpn-MG3Mk1		"Heavy Machinegun"
R-Wpn-Cannon2Mk1		"Medium Cannon"
R-Wpn-Rocket02-MRL		"Pod Rockets Artillery"
R-Wpn-Mortar01Lt		"Mortar"
R-Wpn-Flamer01Mk1		"Flamer"
R-Wpn-Mortar02Hvy		"Heavy Mortar - Bombard"
R-Struc-PowerModuleMk1		"Power Module"
R-Vehicle-Body00		"North-Central American - Light Body - Viper"
R-Vehicle-Body01		"U.S. American - Light Body - Viper"
R-Vehicle-Body02		"German - Light Body - Leopard"
R-Vehicle-Body03		"Canadian - Light Body - Retaliation"
R-Vehicle-Body04		"Cuban - Light Body - Bug"
R-Vehicle-Body05		"U.S. American - Medium Body - Cobra"
R-Vehicle-Body06		"German - Medium Body - Panther"
R-Vehicle-Body07		"Canadian - Medium Body - Retribution"
R-Vehicle-Body08		"Cuban - Medium Body - Scorpion"
R-Vehicle-Body09		"German - Heavy Body - Tiger"
R-Vehicle-Body10		"Canadian - Heavy Body - Vengeance"
R-Vehicle-Body11		"U.S. American - Heavy Body - Python"
R-Vehicle-Body12		"Cuban - Heavy Body - Mantis"
R-Vehicle-Body13		"Japanese - Super Heavy Body - Wyvern"
R-Vehicle-Body14		"Chinese - Extreme Heavy Body - Dragon"
R-Sys-Sensor-Tower01		"Sensor Tower"
R-Defense-WallTower02		"Light Cannon Hardpoint"
R-Defense-WallTower01		"Heavy Machinegun Hardpoint"
R-Defense-WallTower04		"Heavy Cannon Hardpoint"
R-Defense-WallTower03		"Medium Cannon Hardpoint"
R-Sys-Sensor-Turret01		"Sensor Turret"
R-Struc-RepairFacility		"Repair Facility"
R-Wpn-Cannon4AMk1		"Twin Heavy Cannon"
R-Sys-Engineering01		"Engineering"
R-Wpn-Cannon3Mk1		"Heavy Cannon"
R-Wpn-Rocket06-IDF		"Ripple Rocket Artillery"
R-Wpn-HowitzerMk1		"Howitzer Artillery"
CAM1RESEARCH		"CAM1 RESEARCH"
R-Struc-Factory-Cyborg		"Cyborg Factory"
R-Cyborg-Wpn-MG		"Machine Gun Cyborg"
R-Wpn-MG-Damage01		"Hardened MG Bullets"
R-Wpn-MG-ROF01		"Chaingun Upgrade"
R-Wpn-MG-Damage02		"APDSB MG Bullets"
R-Wpn-MG-ROF02		"Rapid Fire Chaingun"
R-Wpn-MG-Damage03		"APDSB MG Bullets Mk2"
R-Wpn-MG-ROF03		"Hyper Fire Chaingun Upgrade"
R-Defense-WallUpgrade01		"Improved Hardcrete"
R-Struc-CommandRelay		"Command Relay Post"
R-Comp-SynapticLink		"Synaptic Link"
R-Vehicle-Engine01		"Fuel Injection Engine"
R-Vehicle-Engine02		"Fuel Injection Engine Mk2"
R-Vehicle-Engine03		"Fuel Injection Engine Mk3"
R-Wpn-Flamer-Damage01		"High Temperature Flamer Gel"
R-Wpn-Flamer-Damage02		"High Temperature Flamer Gel Mk2"
R-Wpn-Flamer-Damage03		"High Temperature Flamer Gel Mk3"
R-Wpn-Flamer-ROF01		"Flamer Autoloader"
R-Wpn-Flamer-ROF02		"Flamer Autoloader Mk2"
R-Wpn-Flamer-ROF03		"Flamer Autoloader Mk3"
R-Wpn-Cannon-Damage01		"HEAT Cannon Shells"
R-Wpn-Cannon-Damage02		"HEAT Cannon Shells Mk2"
R-Wpn-Cannon-Damage03		"HEAT Cannon Shells Mk3"
R-Wpn-Cannon-ROF01		"Cannon Autoloader"
R-Wpn-Mortar-Damage01		"HE Mortar Shells"
R-Wpn-Mortar-Damage02		"HE Mortar Shells Mk2"
R-Wpn-Mortar-Damage03		"HE Mortar Shells Mk3"
R-Wpn-Mortar-ROF01		"Mortar Autoloader"
R-Wpn-Mortar-ROF02		"Mortar Autoloader Mk2"
R-Wpn-Mortar-ROF03		"Mortar Autoloader Mk3"
R-Comp-CommandTurret01		"Command Turret"
R-Defense-TankTrap01		"Tank Traps"
R-Defense-Tower01		"Pod Rockets Guard Tower"
R-Defense-Tower06		"Bunker Buster Tower"
R-Defense-Pillbox01		"Twin Machinegun Bunker"
R-Defense-Pillbox04		"Light Cannon Bunker"
R-Defense-Pillbox05		"Flamer Bunker"
R-Cyborg-Wpn-Flamer		"Flamer Cyborg"
R-Cyborg-Wpn-Cannon		"Cannon Cyborg"
R-Cyborg-Wpn-Rocket		"Pod Rockets Cyborg"
R-Sys-MobileRepairTurret01		"Mobile Repair Turret"
R-Defense-WallUpgrade02		"Improved Hardcrete Mk2"
R-Defense-WallUpgrade03		"Improved Hardcrete Mk3"
R-Struc-Materials01		"Reinforced Base Structure Materials"
R-Struc-Materials02		"Reinforced Base Structure Materials Mk2"
R-Struc-Materials03		"Reinforced Base Structure Materials Mk3"
R-Vehicle-Metals01		"Composite Alloys"
R-Vehicle-Metals02		"Composite Alloys Mk2"
R-Vehicle-Metals03		"Composite Alloys Mk3"
R-Struc-Research-Upgrade01		"Synaptic Link Data Analysis"
R-Struc-Research-Upgrade02		"Synaptic Link Data Analysis Mk2"
R-Struc-Research-Upgrade03		"Synaptic Link Data Analysis Mk3"
R-Struc-Factory-Upgrade01		"Automated Factory Production"
R-Struc-Factory-Upgrade02		"Automated Factory Production Mk2"
R-Struc-Factory-Upgrade03		"Automated Factory Production Mk3"
R-Cyborg-Metals01		"Cyborg Composite Alloys"
R-Cyborg-Metals02		"Cyborg Composite Alloys Mk2"
R-Cyborg-Metals03		"Cyborg Composite Alloys Mk3"
CAM1WEAPONS		"CAM1 WEAPONS"
CAM1SYSTEMS		"CAM1 SYSTEMS"
CAM1DEFENSES		"CAM1 DEFENSES"
CAM1STRUCTURES		"CAM1 STRUCTURES"
R-Wpn-Rocket03-HvAT		"Bunker Buster Rocket"
R-Sys-Sensor-Upgrade01		"Sensor Upgrade"
R-Vehicle-Prop-Halftracks		"Half-tracked Propulsion"
R-Vehicle-Prop-Halftracks02	"Half-tracked Propulsion2"
R-Defense-WallTower06		"Lancer Hardpoint"
R-Defense-Pillbox06		"Lancer Bunker"
R-Wpn-Cannon-Accuracy01		"Cannon Laser Rangefinder"
R-Sys-SpyTurret		"Nexus Link Turret"
R-Wpn-HvyHowitzer		"Heavy Howitzer - Ground Shaker Artillery"
R-Wpn-Rocket-ROF01		"Fast Fire Mini-Rockets"
R-Wpn-Rocket-ROF02		"Fast Fire Mini-Rockets Mk2"
R-Wpn-Rocket-Damage01		"HE Mini-Rockets"
R-Wpn-Rocket-Damage02		"HE Mini-Rockets Mk2"
R-Vehicle-Prop-Wheels		"Wheeled Propulsion"
R-Vehicle-Prop-Wheels02	"Wheeled Propulsion2"
R-Sys-Spade1Mk1		"Construction Unit"
R-Struc-RprFac-Upgrade01		"Automated Repair Facility"
R-Struc-RprFac-Upgrade02		"Automated Repair Facility Upgrade Mk2"
R-Struc-RprFac-Upgrade03		"Automated Repair Facility Upgrade Mk3"
R-Vehicle-Prop-VTOL		"VTOL Propulsion"
R-Vehicle-Prop-VTOL02		"VTOL Propulsion2"
R-Struc-VTOLPad		"VTOL Rearming Pad"
R-Struc-VTOLFactory		"VTOL Factory"
R-Wpn-Cannon5		"Assault Cannon"
R-Wpn-AAGun02		"Cyclone Flak Turret"
R-Wpn-Flame2		"Heavy Flamer - Inferno"
R-Wpn-Howitzer03-Rot		"Rotary Howitzer - Hellstorm Artillery"
R-Wpn-MG4		"Assault Gun"
R-Wpn-Mortar3		"Rotary Mortar - Pepperpot"
R-Wpn-AAGun03		"Hurricane AA Turret"
R-Wpn-AAGun04		"Whirlwind AATurret"
R-Wpn-Laser01		"Light Pulse Laser"
R-Wpn-Laser02		"Twin Pulse Laser"
R-Wpn-Missile2A-T		"Scourge Missile"
R-Wpn-RailGun01		"Needle Gun"
R-Wpn-RailGun02		"Rail Gun"
R-Wpn-RailGun03		"Gauss Cannon"
R-Defense-AASite-QuadBof		"Cyclone AA Site"
R-Defense-AASite-QuadMg1		"Hurricane AA Site"
R-Defense-AASite-QuadRotMg		"Whirlwind AA Site"
R-Defense-PrisLas		"Light Pulse Laser Bunker"
R-Defense-RotHow		"Hellstorm Artillery Site"
R-Defense-RotMor		"Pepperpot Pit"
R-Defense-GuardTower-ATMiss		"Scourge Missile Tower"
R-Defense-GuardTower-Rail1		"Needle Gun Tower"
R-Defense-Howitzer		"Howitzer Artillery Site"
R-Defense-MortarPit		"Mortar Pit"
R-Defense-Wall-RotMg		"Assault Gun Hardpoint"
R-Defense-Wall-VulcanCan		"Assault Cannon Hardpoint"
R-Defense-WallTower-HvyFlamer		"Inferno Hardpoint"
R-Defense-WallTower-PulseLas		"Light Pulse Laser Hardpoint"
R-Defense-WallTower-Rail2		"Rail Gun Hardpoint"
R-Cyborg-Metals04		"Cyborg Dense Composite Alloys"
R-Cyborg-Metals05		"Cyborg Dense Composite Alloys Mk2"
R-Cyborg-Metals06		"Cyborg Dense Composite Alloys Mk3"
R-Cyborg-Metals07		"Cyborg Superdense Composite Alloys"
R-Cyborg-Metals08		"Cyborg Superdense Composite Alloys Mk2"
R-Cyborg-Metals09		"Cyborg Superdense Composite Alloys Mk3"
R-Vehicle-Metals04		"Dense Composite Alloys"
R-Vehicle-Metals05		"Dense Composite Alloys Mk2"
R-Vehicle-Metals06		"Dense Composite Alloys Mk3"
R-Vehicle-Metals07		"Superdense Composite Alloys"
R-Vehicle-Metals08		"Superdense Composite Alloys Mk2"
R-Vehicle-Metals09		"Superdense Composite Alloys Mk3"
R-Wpn-Cannon-Damage04		"APFSDS Cannon Rounds"
R-Wpn-Cannon-Damage05		"APFSDS Cannon Rounds Mk2"
R-Wpn-Cannon-Damage06		"APFSDS Cannon Rounds Mk3"
R-Wpn-Cannon-Damage07		"HVAPFSDS Cannon Rounds"
R-Wpn-Cannon-Damage08		"HVAPFSDS Cannon Rounds Mk2"
R-Wpn-Cannon-Damage09		"HVAPFSDS Cannon Rounds Mk3"
R-Wpn-Cannon-ROF02		"Cannon Autoloader Mk2"
R-Wpn-Cannon-ROF03		"Cannon Autoloader Mk3"
R-Wpn-Cannon-ROF04		"Cannon Rapid Loader"
R-Wpn-Cannon-ROF05		"Cannon Rapid Loader Mk2"
R-Wpn-Cannon-ROF06		"Cannon Rapid Loader Mk3"
R-Wpn-Cannon-Accuracy02		"Cannon Laser Designator"
R-Sys-Sensor-Tower02		"Hardened Sensor Tower"
R-Wpn-Rocket07-Tank-Killer		"Tank Killer Rocket"
R-Cyborg-Legs01		"Cyborg Propulsion"
R-Cyborg-Wpn-RotMG-Grd		"Assault Gun Cyborg"
R-Cyborg-Wpn-Rail1-Grd		"Needle Gun Cyborg"
R-Cyborg-Wpn-ATMiss-Grd		"Lancer Cyborg"
R-Cyborg-Wpn-Laser1-Grd		"Light Pulse Laser Cyborg"
R-Defense-HvyFlamer		"Inferno Emplacement"
R-Defense-SamSite1		"Avenger SAM Site"
R-Defense-SamSite2		"Vindicator SAM Site"
R-Defense-HvyHowitzer		"Ground Shaker Artillery Site"
R-Defense-MRL		"Mini-Rocket Artillery Site"
R-Defense-RotMG		"Rotary MG Bunker"
R-Defense-RotCannon		"Rotary Cannon Bunker"
R-Defense-HvyMor		"Bombard Pit"
R-Defense-IDFRocket		"Ripple Rocket Artillery Site"
R-Defense-HvyA-Trocket		"Tank Killer Bunker"
R-Defense-Emplacement-HPVcannon		"Twin Heavy Cannon Hardpoint"
R-Defense-PulseLas		"Twin Pulse Laser Bunker"
R-Defense-Rail2		"Rail Gun Bunker"
R-Defense-Rail3		"Gauss Cannon Bunker"
R-Defense-MdArtMissile		"Condor Missile Artillery Site"
R-Defense-HvyArtMissile		"Archangel Missile Artillery Site"
R-Defense-WallTower-HvyA-Trocket		"Tank Killer Hardpoint"
R-Defense-WallTower-HPVcannon		"Twin Heavy Cannon Bunker"
R-Defense-WallTower-A-Tmiss		"Scourge Missile Hardpoint"
R-Defense-WallUpgrade04		"Supercrete"
R-Defense-WallUpgrade05		"Supercrete Mk2"
R-Defense-WallUpgrade06		"Supercrete Mk3"
R-Defense-WallUpgrade07		"Plascrete"
R-Defense-WallUpgrade08		"Plascrete Mk2"
R-Defense-WallUpgrade09		"Plascrete MK3"
R-Struc-Factory-Upgrade04		"Robotic Factory Production"
R-Struc-Factory-Upgrade05		"Robotic Factory Production Mk2"
R-Struc-Factory-Upgrade06		"Robotic Factory Production Mk3"
R-Struc-Factory-Cyborg-Upgrade01		"Automated Cyborg Production"
R-Struc-Factory-Cyborg-Upgrade02		"Automated Cyborg Production Mk2"
R-Struc-Factory-Cyborg-Upgrade03		"Automated Cyborg Production Mk3"
R-Struc-Factory-Cyborg-Upgrade04		"Robotic Cyborg Production"
R-Struc-Factory-Cyborg-Upgrade05		"Robotic Cyborg Production Mk2"
R-Struc-Factory-Cyborg-Upgrade06		"Robotic Cyborg Production Mk3"
R-Struc-VTOLFactory-Upgrade01		"Robotic VTOL Production"
R-Struc-VTOLFactory-Upgrade02		"Robotic VTOL Production Mk2"
R-Struc-VTOLFactory-Upgrade03		"Robotic VTOL Production Mk3"
R-Struc-VTOLFactory-Upgrade04		"Advanced VTOL Production"
R-Struc-VTOLFactory-Upgrade05		"Advanced VTOL Production Mk2"
R-Struc-VTOLFactory-Upgrade06		"Advanced VTOL Production Mk3"
R-Struc-VTOLPad-Upgrade01		"Automated VTOL Rearming"
R-Struc-VTOLPad-Upgrade02		"Automated VTOL Rearming Mk2"
R-Struc-VTOLPad-Upgrade03		"Automated VTOL Rearming Mk3"
R-Struc-VTOLPad-Upgrade04		"Robotic VTOL Rearming"
R-Struc-VTOLPad-Upgrade05		"Robotic VTOL Rearming Mk2"
R-Struc-VTOLPad-Upgrade06		"Robotic VTOL Rearming Mk3"
R-Struc-Materials04		"Hardened Base Structure Materials"
R-Struc-Materials05		"Hardened Base Structure Materials Mk2"
R-Struc-Materials06		"Hardened Base Structure Materials Mk3"
R-Struc-Materials07		"Advanced Base Structure Materials"
R-Struc-Materials08		"Advanced Base Structure Materials Mk2"
R-Struc-Materials09		"Advanced Base Structure Materials Mk3"
R-Struc-Power-Upgrade01		"Gas Turbine Generator"
R-Struc-Power-Upgrade02		"Vapor Turbine Generator"
R-Struc-Research-Upgrade04		"Dedicated Synaptic Link Data Analysis"
R-Struc-Research-Upgrade05		"Dedicated Synaptic Link Data Analysis Mk2"
R-Struc-Research-Upgrade06		"Dedicated Synaptic Link Data Analysis Mk3"
R-Struc-Research-Upgrade07		"Neural Synapse Research Brain"
R-Struc-Research-Upgrade08		"Neural Synapse Research Brain Mk2"
R-Struc-Research-Upgrade09		"Neural Synapse Research Brain Mk3"
R-Struc-RprFac-Upgrade04		"Robotic Repair Facility Upgrade"
R-Struc-RprFac-Upgrade05		"Robotic Repair Facility Upgrade Mk2"
R-Struc-RprFac-Upgrade06		"Robotic Repair Facility Upgrade Mk3"
R-Sys-Engineering02		"Improved Engineering"
R-Sys-Engineering03		"Advanced Engineering"
R-Sys-CBSensor-Turret01		"CB Turret"
R-Sys-CBSensor-Tower01		"CB Tower"
R-Sys-VTOLCBS-Turret01		"VTOL CB Turret"
R-Sys-VTOLCBS-Tower01		"VTOL CB Tower"
R-Sys-VTOLStrike-Turret01		"VTOL Strike Turret"
R-Sys-VTOLStrike-Tower01		"VTOL Strike Tower"
R-Vehicle-Engine04		"Turbo-Charged Engine"
R-Vehicle-Engine05		"Turbo-Charged Engine Mk2"
R-Vehicle-Engine06		"Turbo-Charged Engine Mk3"
R-Vehicle-Engine07		"Gas Turbine Engine"
R-Vehicle-Engine08		"Gas Turbine Engine Mk2"
R-Vehicle-Engine09		"Gas Turbine Engine Mk3"
R-Wpn-AAGun-Accuracy01		"AA Thermal Imaging Sensor"
R-Wpn-AAGun-Accuracy02		"AA Target Acquisition Shells"
R-Wpn-AAGun-Accuracy03		"AA Target Prediction Computer"
R-Wpn-AAGun-Damage01		"AA HE Flak"
R-Wpn-AAGun-Damage02		"AA HE Flak Mk2"
R-Wpn-AAGun-Damage03		"AA HE Flak Mk3"
R-Wpn-AAGun-Damage04		"AA HEAP Flak"
R-Wpn-AAGun-Damage05		"AA HEAP Flak Mk2"
R-Wpn-AAGun-Damage06		"AA HEAP Flak Mk3"
R-Wpn-AAGun-ROF01		"AA Ammunition Hopper"
R-Wpn-AAGun-ROF02		"AA Ammunition Hopper Mk2"
R-Wpn-AAGun-ROF03		"AA Ammunition Hopper Mk3"
R-Wpn-AAGun-ROF04		"AA Chainfeed Loader"
R-Wpn-AAGun-ROF05		"AA Chainfeed Loader Mk2"
R-Wpn-AAGun-ROF06		"AA Chainfeed Loader Mk3"
R-Wpn-Bomb01		"Cluster Bombs Bay"
R-Wpn-Bomb02		"HEAP Bomb Bay"
R-Wpn-Bomb03		"Phosphor Bomb Bay"
R-Wpn-Bomb04		"Thermite Bomb Bay"
R-Wpn-Flamer-Damage04		"Superhot Flamer Gel"
R-Wpn-Flamer-Damage05		"Superhot Flamer Gel Mk2"
R-Wpn-Flamer-Damage06		"Superhot Flamer Gel Mk3"
R-Wpn-Howitzer-Accuracy01		"Target Acquisition Artillery Shells"
R-Wpn-Howitzer-Accuracy02		"Target Acquisition Artillery Shells Mk2"
R-Wpn-Howitzer-Accuracy03		"Target Prediction Artillery Shells"
R-Wpn-Howitzer-Damage01		"HE Howitzer Shells"
R-Wpn-Howitzer-Damage02		"HE Howitzer Shells Mk2"
R-Wpn-Howitzer-Damage03		"HE Howitzer Shells Mk3"
R-Wpn-Howitzer-Damage04		"HEAP Howitzer Shells"
R-Wpn-Howitzer-Damage05		"HEAP Howitzer Shells Mk2"
R-Wpn-Howitzer-Damage06		"HEAP Howitzer Shells Mk3"
R-Wpn-Energy-Accuracy01		"Improved Laser Focusing"
R-Wpn-Energy-Damage01		"Hi-Energy Laser Emitter"
R-Wpn-Energy-Damage02		"Hi-Energy Laser Emitter Mk2"
R-Wpn-Energy-Damage03		"Hi-Energy Laser Emitter Mk3"
R-Wpn-Energy-ROF01		"Thermopole Energizer"
R-Wpn-Energy-ROF02		"Thermopole Energizer Mk2"
R-Wpn-Energy-ROF03		"Thermopole Energizer Mk3"
R-Wpn-Missile-Accuracy01		"Target Prediction Missiles"
R-Wpn-Missile-Accuracy02		"Search & Destroy Missiles"
R-Wpn-Missile-Damage01		"Advanced Missile Warhead"
R-Wpn-Missile-Damage02		"Advanced Missile Warhead Mk2"
R-Wpn-Missile-Damage03		"Advanced Missile Warhead Mk3"
R-Wpn-Mortar-Damage04		"HEAP Mortar Shells"
R-Wpn-Mortar-Damage05		"HEAP Mortar Shells Mk2"
R-Wpn-Mortar-Damage06		"HEAP Mortar Shells Mk3"
R-Wpn-Rail-Accuracy01		"Target Prediction Computer"
R-Wpn-Rail-Damage01		"Hardened Rail Dart"
R-Wpn-Rail-Damage02		"Hardened Rail Dart Mk2"
R-Wpn-Rail-Damage03		"Hardened Rail Dart Mk3"
R-Wpn-Rail-ROF01		"Rail Gun Energizer"
R-Wpn-Rail-ROF02		"Rail Gun Energizer Mk2"
R-Wpn-Rail-ROF03		"Rail Gun Energizer Mk3"
R-Wpn-Rocket-Accuracy01		"Stabilized Mini-Rockets"
R-Wpn-Rocket-Accuracy02		"Stabilized Mini-Rockets Mk2"
R-Wpn-Rocket-Damage03		"HE Mini-Rockets Mk3"
R-Wpn-Rocket-Damage04		"HEAP Mini-Rockets"
R-Wpn-Rocket-Damage05		"HEAP Mini-Rockets Mk2"
R-Wpn-Rocket-Damage06		"HEAP Mini-Rockets Mk3"
R-Wpn-Rocket-ROF03		"Fast Fire Mini-Rockets Mk3"
R-Wpn-RocketSlow-Accuracy01		"Improved Rocket Wire Guidance"
R-Wpn-RocketSlow-Accuracy02		"Rocket Laser Designator"
R-Wpn-RocketSlow-Accuracy03		"Thermal Imaging Rockets"
R-Wpn-RocketSlow-Damage01		"HEAT Rocket Warhead"
R-Wpn-RocketSlow-Damage02		"HEAT Rocket Warhead Mk2"
R-Wpn-RocketSlow-Damage03		"HEAT Rocket Warhead Mk3"
R-Wpn-RocketSlow-Damage04		"HESH Rocket Warhead"
R-Wpn-RocketSlow-Damage05		"HESH Rocket Warhead Mk2"
R-Wpn-RocketSlow-Damage06		"HESH Rocket Warhead Mk3"
R-Defense-WallTower-Rail3		"Gauss Cannon Hardpoint"
R-Wpn-Mortar-ROF04		"Mortar Fast Loader"
R-Cyborg-Hvywpn-HPV		"Grenadier Cyborg"
R-Vehicle-Armor-Heat01		"Thermal Amour"
R-Vehicle-Armor-Heat02		"Thermal Amour Mk2"
R-Vehicle-Armor-Heat03		"Thermal Amour Mk3"
R-Defense-MassDriver		"Mass Driver Fortress"
R-Defense-Super-Cannon		"Cannon Fortress"
R-Vehicle-Armor-Heat04		"High Intensity Thermal Armor"
R-Vehicle-Armor-Heat05		"High Intensity Thermal Armor Mk2"
R-Vehicle-Armor-Heat06		"High Intensity Thermal Armor Mk3"
R-Cyborg-Armor-Heat01		"Cyborg Thermal Amour"
R-Cyborg-Armor-Heat02		"Cyborg Thermal Amour Mk2"
R-Cyborg-Armor-Heat03		"Cyborg Thermal Amour Mk3"
R-Cyborg-Armor-Heat04		"Cyborg High Intensity Thermal Armor"
R-Cyborg-Armor-Heat05		"Cyborg High Intensity Thermal Armor Mk2"
R-Cyborg-Armor-Heat06		"Cyborg High Intensity Thermal Armor Mk3"
R-Wpn-Bomb-Accuracy01		"Thermal Imaging Bombsight"
R-Wpn-Bomb-Accuracy02		"Laser Guided Bombsight"
R-Wpn-Bomb-Accuracy03		"Target Acquisition Bombsight"
R-Wpn-Mortar-Acc01		"Mortar Targeting Computer"
R-Wpn-Mortar-Acc02		"Thermal Imaging Mortar Shells"
R-Wpn-Mortar-Acc03		"Target Acquisition Mortar Shells"
R-Wpn-Howitzer-ROF01		"Howitzer Autoloader"
R-Wpn-Howitzer-ROF02		"Howitzer Autoloader Mk2"
R-Wpn-Howitzer-ROF03		"Howitzer Autoloader Mk3"
R-Wpn-Howitzer-ROF04		"Fast Loader"
R-Wpn-Missile-LtSAM		"Avenger SAM"
R-Wpn-Missile-HvSAM		"Vindicator SAM"
R-Wpn-MdArtMissile		"Condor Missile Artillery"
R-Wpn-HvArtMissile		"Archangel Missile Artillery"
R-Defense-Pillbox-RotMG		"Rotary MG Bunker"
R-Sys-Sensor-Upgrade02		"Sensor Upgrade Mk2"
R-Struc-Power-Upgrade03		"Vapor Turbine Generator Mk2"
R-Struc-Power-Upgrade01b		"Gas Turbine Generator Mk2"
R-Struc-Power-Upgrade01c		"Gas Turbine Generator Mk3"
R-Struc-Power-Upgrade03a		"Vapor Turbine Generator Mk3"
R-Cyborg-Hvywpn-Mcannon		"Super Cannon Cyborg"
R-Cyborg-Hvywpn-Acannon		"Super Assault Cannon Cyborg"
R-Cyborg-Hvywpn-TK		"Super Tank Killer Cyborg"
R-Sys-Autorepair-General		"Auto-Repair"
R-Sys-Resistance-Circuits		"Resistance Circuits"
R-Wpn-Cannon6TwinAslt		"Twin Assault Cannon"
R-Defense-Cannon6		"Twin Assault Cannon Bunker"
R-Wpn-HvyLaser		"Heavy Pulse Laser"
R-Defense-HeavyLas		"Heavy Pulse Laser Bunker"
R-Sys-Sensor-WSTower		"Wide Spectrum Sensor Tower"
R-Sys-Sensor-UpLink		"Satellite Uplink Center"
R-Wpn-LasSat		"Nuclear Missile Silo"
R-Wpn-PlasmaCannon		"Plasma Cannon"
R-Cyborg-Hvywpn-PulseLsr		"Super Pulse Laser Cyborg"
R-Cyborg-Hvywpn-RailGunner		"Super Rail Gun Cyborg"
R-Cyborg-Hvywpn-A-T		"Super Scourge Cyborg"
R-Sys-SpyTower		"NEXUS Link Tower"
R-Defense-PlasmaCannon		"Plasma Cannon Bunker"
R-Defense-EMPCannon		"EMP Cannon Hardponit"
R-Defense-Super-Rocket		"Heavy Rocket Bastion"
R-Defense-Super-Missile		"Missile Fortress"
R-Defense-WallUpgrade10		"Heavy Wall - Plasteel Mk1"
R-Defense-WallUpgrade11		"Heavy Wall - Corundum Mk2"
R-Defense-WallUpgrade12		"Heavy Wall - Diamond Mk3"
R-Defense-WallUpgrade13		"Heavy Wall - Boron Mk4"
R-Wpn-Flamer-Damage07		"Superhot Plasmite gel"
R-Wpn-Flamer-Damage08		"Superhot Plasmite gel Mk2"
R-Wpn-Flamer-Damage09		"Superhot Plasmite gel Mk3"
R-Struc-Factory-Upgrade07		"Advanced Factory Production"
R-Struc-Factory-Upgrade08		"Advanced Factory Production Mk2"
R-Struc-Factory-Upgrade09		"Advanced Factory Production Mk3"
R-Struc-Factory-Cyborg-Upgrade07		"Advanced Cyborg Production"
R-Struc-Factory-Cyborg-Upgrade08		"Advanced Cyborg Production Mk2"
R-Struc-Factory-Cyborg-Upgrade09		"Advanced Cyborg Production Mk3"
R-Wpn-MortarEMP		"EMP Mortar"
R-Wpn-AALaser		"Hyper Fire Laser"
R-Defense-AA-Laser		"Hyper Fire Laser Hardpoint"
R-Defense-EMPMortar		"EMP Mortar Pit"
R-Defense-WallTower-SamHvy		"Vindicator Hardpoint"
R-Defense-WallTower-QuadRotAA		"Whirlwind Hardpoint"
R-Sys-Sensor-WS		"Wide Spectrum Sensor"
R-Wpn-EMPCannon		"EMP Cannon"
R-Defense-WallTower-DoubleAAgun	"Cyclone Hardpoint"
R-Defense-WallTower-SamSite		"Avenger Hardpoint"
R-Wpn-MG5					"Twin Assault Gun"
R-Defense-WallTower-TwinAGun		"Twin Assault Gun Hardpoint"
R-Wpn-Bomb05		"Plasmite Bomb"
R-Wpn-Bomb06		"EMP Missile Launcher"
R-Wpn-LasSat_3		"Nuclear Reactor"
R-Wpn-HGC						"Heavy Gauss Cannon"
R-Defense-WallTower-HGC				"Heavy Gauss Cannon Hardpoint"
R-Struc-Factory-Cyborg-Upgrade-extra 	"Cyborg extra"
R-StakeMark_h					"Gate"
R-Defense-A0BaBaBunker			"Scavenger Machinegun Bunker"
R-Defense-A0BaBaFlameTower		"Scavenger Flame Tower"
R-Defense-A0BaBaGunTower		"Scavenger Machinegun Tower"
R-Defense-A0BaBaHorizontalWall	"Scavenger Horizontal Wall"
R-Defense-A0BaBaMortarPit		"Scavenger Mortar Pit"
R-Defense-A0BaBaRocketPit		"Scavenger Pod Rockets Site"
R-Defense-A0CannonTower			"Scavenger Light Cannon Tower"
R-Wpn-GShield				"Anti Ground Shield"
R-Defense-Plas-Art			"Plasma Artillery Site"
R-Wpn-Plas-Art				"Plasma Artillery"
R-Wpn-Incenediary-Mortar		"Incendiary Mortar"
R-Defense-Incenediary-Mortar-Pit	"Incendiary Mortar Pit"
R-Wpn-Laser-Sat			"Laser Satellite"
R-Wpn-MG-Damage04			"APDSB MG Bullets Mk3"
R-Wpn-MG-Damage05			"Tungsten-Tipped MG Bullets"
R-Wpn-MG-Damage06			"Tungsten-Tipped MG Bullets Mk2"
R-Wpn-MG-Damage07			"Tungsten-Tipped MG Bullets Mk3"
R-Wpn-MG-Damage08			"Depleted Uranium MG Bullets"
R-Wpn-MG-Damage09			"Depleted Uranium MG Bullets Mk2"
R-Wpn-TUTMG				"Machinegun Artifact"
R-Sys-Resistance			"NEXUS Intruder Program"
R-Sys-Resistance-Upgrade01		"NEXUS Resistance Circuits"
R-Sys-Resistance-Upgrade02		"NEXUS Resistance Circuits Mk2"
R-Sys-Resistance-Upgrade03		"NEXUS Resistance Circuits Mk3"
R-Comp-MissileCodes01			"Missile Targeting Codes"
R-Comp-MissileCodes02			"Second Level Missile Targeting Codes"
R-Comp-MissileCodes03			"Third Level Missile Firing Codes"
R-Sys-NEXUSrepair			"*R-Sys-NEXUSrepair*"

// Structures
Laser-Sat		"Laser Satellite"
Incenediary-Mortar-Pit 	"Incendiary Mortar Pit"
GShield			"Anti Ground Shield"
GateGround			"Gate Vertical"
GateGround_h		"Gate Horizontal"
GateStake			"Gate Door Vertical"
GateStake_h			"Gate Door Horizontal"
StakeMark			"Gate Vertical"
StakeMark_h			"Gate Horizontal"
AAShield		"Anti Aircraft Shield"
A0TankTrap2		"EMP Tank Traps"
Super-Wall		"Heavy Wall"
Super-CWall		"Heavy Corner Wall"
A0ADemolishStructure		"Demolish Structure"
A0BaBaBunker		"Scavenger Machinegun Bunker"
A0BabaCornerWall		"Scavenger Corner Wall"
A0BaBaFactory		"Factory"
A0BaBaFlameTower		"Scavenger Flame Tower"
A0BaBaGunTower		"Scavenger Machinegun Tower"
A0BaBaGunTowerEND		"*Scavenger End Tower*"
A0BaBaHorizontalWall		"Scavenger Horizontal Wall"
A0BaBaMortarPit		"Scavenger Mortar Pit"
A0BaBaPowerGenerator		"Power Generator"
A0BaBaRocketPit		"Scavenger Pod Rockets Site"
A0BaBaRocketPitAT		"Scavenger AT-Rocket Site"
A0CannonTower		"Scavenger Light Cannon Tower"
A0ComDroidControl		"Command Relay Center"
A0CommandCentre		"Command Center"
A0CommandCentreDEL	"Command Center2"
A0CommandCentreCO		"Collective Command Center"
A0CommandCentreNE		"*CommandCenterNE*"
A0CommandCentreNP		"New Paradigm Command Center"
A0CyborgFactory		"Cyborg Factory"
A0FacMod1		"Factory Module"
A0HardcreteMk1CWall		"Hardcrete Corner Wall"
A0HardcreteMk1Wall		"Hardcrete Wall"
A0LasSatCommand		"Nuclear Missile Silo"
A0LightFactory		"Factory"
A0PowerGenerator		"Power Generator"
A0PowMod1		"Power Module"
A0RepairCentre3		"Repair Facility"
A0ResearchFacility		"Research Facility"
A0ResearchModule1		"Research Module"
A0ResourceExtractor		"Oil Derrick"
A0Sat-linkCentre		"Satellite Uplink Center"
A0TankTrap		"Tank Traps"
A0VTolFactory1		"VTOL Factory"
A0VtolPad		"VTOL Rearming Pad"
AASite-QuadBof		"Cyclone AA Site"
AASite-QuadMg1		"Hurricane AA Site"
AASite-QuadRotMg		"Whirlwind AA Site"
CO-Tower-HvATRkt		"*CO-Tower-HvATRkt*"
CO-Tower-HVCan		"*CO-Tower-HVCan*"
CO-Tower-HvFlame		"*CO-Tower-HvFlame*"
CO-Tower-LtATRkt		"*CO-Tower-LtATRkt*"
CO-Tower-MdCan		"*CO-Tower-MdCan*"
CO-Tower-MG3		"*CO-Tower-MG3*"
CO-Tower-RotMG		"*CO-Tower-RotMG*"
CO-WallTower-HvCan		"*CO-WallTower-HvCan*"
CO-WallTower-RotCan		"*CO-WallTower-RotCan*"
CollectiveCWall		"Collective CWall"
CollectiveWall		"Collective Wall"
CoolingTower		"Cooling Tower"
Emplacement-HeavyLaser		"Heavy Pulse Laser Bunker"
Emplacement-Howitzer-Incenediary		"Incenediary Howitzer Artillery Site"
Emplacement-Howitzer105		"Howitzer Artillery Site"
Emplacement-Howitzer150		"Ground Shaker Artillery Site"
Emplacement-HPVcannon		"Twin Heavy Cannon Hardpoint"
Emplacement-HvART-pit		"Archangel Missile Artillery Site"
Emplacement-HvyATrocket		"Tank Killer Bunker"
Emplacement-MdART-pit		"Condor Missile Artillery Site"
Emplacement-MortarEMP		"EMP Mortar"
Emplacement-MortarPit-Incenediary		"Super Twin Cannon Bunker"
Emplacement-MortarPit01		"Mortar Pit"
Emplacement-MortarPit02		"Bombard Pit"
Emplacement-MRL-pit		"Pod Rockets Artillery Site"
Emplacement-PlasmaCannon		"Plasma Cannon Bunker"
Emplacement-PrisLas		"Light Pulse Laser Bunker"
Emplacement-PulseLaser		"Twin Pulse Laser Bunker"
Emplacement-Rail2		"Rail Gun Bunker"
Emplacement-Rail3		"Gauss Cannon Bunker"
Emplacement-Rocket06-IDF		"Ripple Rocket Artillery Site"
Emplacement-RotHow		"Hellstorm Artillery Site"
Emplacement-RotMor		"Pepperpot Pit"
GuardTower-ATMiss		"Scourge Missile Tower"
GuardTower-BeamLas		"*GuardTower-BeamLas*"
GuardTower-Rail1		"Needle Gun Tower"
GuardTower-RotMg		"Assault Gun Guard Tower"
GuardTower1		"Pod Rockets Guard Tower"
GuardTower2		"Twin Machinegun Guard Tower"
GuardTower3		"Heavy Machinegun Guard Tower"
GuardTower4		"Flamer Guard Tower"
GuardTower5		"Lancer Guard Tower"
GuardTower6		"Bunker Buster Tower"
LookOutTower		"Command Center"
NEXUSCWall		"NEXUS CWall"
NEXUSWall		"NEXUS Wall"
NuclearReactor		"Nuclear Reactor"
NX-ANTI-SATSite		"Missile Silo"
NX-CruiseSite		"Missile Silo"
NX-Emp-MedArtMiss-Pit		"*NX-Emp-MedArtMiss-Pit*"
NX-Emp-MultiArtMiss-Pit		"*NX-Emp-MultiArtMiss-Pit*"
NX-Emp-Plasma-Pit		"Plasma Artillery Site"
NX-Tower-ATMiss		"*NX-Tower-ATMiss*"
NX-Tower-PulseLas		"*NX-Tower-PulseLas*"
NX-Tower-Rail1		"*NX-Tower-Rail1*"
NX-WallTower-BeamLas		"*NX-WallTower-BeamLas*"
NX-WallTower-Rail2		"*NX-WallTower-Rail2*"
NX-WallTower-Rail3		"*NX-WallTower-Rail3*"
P0-AASite-Laser		"Hyper Fire Laser Hardpoint"
P0-AASite-SAM1		"Avenger SAM Site"
P0-AASite-SAM2		"Vindicator SAM Site"
PillBox-Cannon6		"Twin Assault Cannon Bunker"
Pillbox-RotMG		"Rotary MG Bunker"
PillBox1		"Machinegun Bunker"
PillBox2		"Twin Machinegun Bunker"
PillBox3		"Heavy Machinegun Bunker"
PillBox4		"Light Cannon Bunker"
PillBox5		"Flamer Bunker"
PillBox6		"Lancer Bunker"
Plasmite-flamer-bunker		"Plasmite Bunker"
Sys-CB-Tower01		"CB Tower"
Sys-NEXUSLinkTOW		"*Sys-NEXUSLinkTOW*"
Sys-NX-CBTower		"*Sys-NX-CBTower*"
Sys-NX-SensorTower		"*Sys-NX-SensorTower*"
Sys-NX-VTOL-CB-Tow		"*Sys-NX-VTOL-CB-Tow*"
Sys-NX-VTOL-RadTow		"*Sys-NX-VTOL-RadTow*"
Sys-SensoTower01		"Sensor Tower"
Sys-SensoTower02		"Hardened Sensor Tower"
Sys-SensoTowerWS		"Wide Spectrum Sensor Tower"
Sys-SpyTower		"NEXUS Link Tower"
Sys-VTOL-CB-Tower01		"VTOL CB Tower"
Sys-VTOL-RadarTower01		"VTOL Strike Tower"
TankTrapC		"Tank Traps"
Tower-Projector		"Inferno Emplacement"
Tower-RotMg		"Assault Gun Guard Tower"
Tower-VulcanCan		"Assault Cannon Guard Tower"
UplinkCentre		"*UplinkCentre*"
Wall-RotMg		"Assault Gun Hardpoint"
Wall-VulcanCan		"Assault Cannon Hardpoint"
WallTower-Atmiss		"Scourge Missile Hardpoint"
WallTower-DoubleAAGun		"Cyclone Hardpoint"
WallTower-EMP		"EMP Cannon Hardponit"
WallTower-HPVcannon		"Twin Heavy Cannon Bunker"
WallTower-HvATrocket		"Tank Killer Hardpoint"
WallTower-Projector		"Inferno Hardpoint"
WallTower-PulseLas		"Light Pulse Laser Hardpoint"
WallTower-QuadRotAAGun		"Whirlwind Hardpoint"
WallTower-Rail2		"Rail Gun Hardpoint"
WallTower-Rail3		"Gauss Cannon Hardpoint"
WallTower-Rail4		"Heavy Gauss Cannon Hardpoint"
WallTower-SamHvy		"Vindicator Hardpoint"
WallTower-SamSite		"Avenger Hardpoint"
WallTower-TwinAssaultGun		"Twin Assault Gun Tower"
WallTower01		"Heavy Machinegun Hardpoint"
WallTower02		"Light Cannon Hardpoint"
WallTower03		"Medium Cannon Hardpoint"
WallTower04		"Heavy Cannon Hardpoint"
WallTower05		"Flamer Hardpoint"
WallTower06		"Lancer Hardpoint"
WreckedTransporter		"Downed Transport"
X-Super-Cannon		"Cannon Fortress"
X-Super-MassDriver		"Mass Driver Fortress"
X-Super-Missile		"Missile Fortress"
X-Super-Rocket		"Heavy Rocket Bastion"
ContaMine1		"Light Contact Mine"
ContaMine2		"Anti-Tank Contact Mine"
ContaMine3		"Incendiary Contact Mine"
ContaMine4		"Shrapnel Contact Mine"
ContaMine5		"Heavy Anti-Tank Mine"
ContaMine6		"Plasmite Mine"
ContaMine7		"EMP Contact Mine"
ContaMine8		"Omega Contact Mine"
mineinfo		"Mines Sign"

// Feature types
ContaMine		"Land Mine (all types)"
Crate		"Artifact"
OilResource		"Oil Resource"
Boulder1		"*Boulder 1*"
Boulder2		"*Boulder 2*"
Boulder3		"*Boulder 3*"
WreckedDroidHub		"Wreck"
WreckedVertCampVan		"Wrecked Van"
WreckedSuzukiJeep		"Wrecked Vehicle"
WreckedTankerV		"Wrecked Tanker"
building1		"*Building 1*"
building2		"*Building 2*"
building3		"*Building 3*"
building7		"*Building 7*"
building8		"*Building 8*"
building10		"*Building 10*"
building11		"*Building 11*"
building12		"*Building 12*"
Ruin5		"*Ruin5*"
Ruin4		"*Ruin4*"
Ruin3		"*Ruin3*"
Ruin1		"*Ruin1*"
miruin2		"*miruin*2"
BarbTechRuin		"Ruined Factory"
BarbWarehouse1		"Warehouse"
BarbHUT		"Hut"
BarbWarehouse2		"*Warehouse2*"
BarbWarehouse3		"*Warehouse3*"
WaterBuilding		"*Water Building*"
Pipe		"*Pipe*"
Pipe1		"*Pipe1*"
WaterBuilding2		"*Water Building2*"
WaterBuilding3		"*Water Building3*"
OilDrum		"Oil Drum"
WreckedBuilding16		"*Wrecked Building 16*"
WreckedBuilding17		"*Wrecked Building 17*"
WreckedBuilding9		"*Wrecked Building 9*"
WreckedBridge		"Wrecked Bridge"
Chevy		"*Chevy*"
Crane		"*Crane*"
WaterTower		"*Water Tower*"
OilTower		"*Oil Tower*"
BlueCar		"*Blue Car*"
Pickup		"*Pickup*"
Pylon		"*Pylon*"
Tree1		"*Tree1*"
Tree2		"*Tree2*"
Tree3		"*Tree3*"
TreeSnow1		"*Snowy Tree1*"
TreeSnow2		"*Snowy Tree2*"
TreeSnow3		"*Snowy Tree3*"
LogCabin1		"*LogCabin1*"
LogCabin2		"*LogCabin2*"
LogCabin3		"*LogCabin3*"
LogCabin4		"*LogCabin4*"
LogCabin5		"*LogCabin5*"
OldFactory		"*OldFactory*"
AirTrafficControl		"*AirTrafficControl*"


//NEW TEMPLATES

A-Viper-Wheels-MG			"Viper Wheels Machinegun"
A-Viper-Wheels-TMG			"Viper Wheels Twin Machinegun"
A-Viper-Wheels-HMG			"Viper Wheels Heavy Machinegun"
A-Cobra-Wheels-HMG			"Cobra Wheels Heavy Machinegun"
A-Cobra-Hover-HMG			"Cobra Hover Heavy Machinegun"
A-Viper-Trk-MG				"Viper Tracks Machinegun"
A-Viper-Trk-TMG				"Viper Tracks Twin Machinegun"
A-Viper-Trk-HMG				"Viper Tracks Heavy Machinegun"
A-Cobra-Trk-HMG				"Cobra Tracks Heavy Machinegun"
A-Cobra-Hover-MC			"Cobra Hover Medium Cannon"
A-Scorp-Hover-MC			"Scorpion Hover Medium Cannon"
A-Scorp-Trk-MC				"Scorpion Tracks Medium Cannon"
A-Python-Hover-MC			"Python Hover Medium Cannon"
A-Python-Hover-HC			"Python Hover Heavy Cannon"
A-Python-Trk-HC				"Python Tracks Heavy Cannon"
A-Mantis-Trk-Rail			"Mantis Tracks Railgun"
A-Mantis-Trk-Pulse			"Mantis Tracks Pulse Laser"
A-Python-Trk-Lancer			"Python Tracks Lancer"
A-Mantis-Trk-Lancer			"Mantis Tracks Lancer"
A-Veng-Trk-TK				"Vengeance Tracks Tank Killer"
A-Tiger-Trk-HC				"Tiger Tracks Heavy Cannon"
A-Tiger-Trk-Needle			"Tiger Tracks Needle Gun"
A-Retrib-Trk-Needle			"Retribution Tracks Needle Gun"
A-Veng-Trk-Needle			"Vengeance Tracks Needle Gun"
A-Veng-Trk-Rail				"Vengeance Tracks Rail Gun"
A-Veng-Trk-Guass			"Vengeance Tracks Gauss Cannon"
A-Veng-Trk-Scourge			"Vengeance Tracks Gauss Scourge"
V-Bug-ClusterBomb			"Bug Cluster Bomb VTOL"
V-Bug-BB				"Bug Bunker Buster VTOL"
V-Scor-ClusterBomb			"Scorpion Cluster Bomb VTOL"
V-Scor-BB				"Scorpion Bunker Buster VTOL"
V-Bug-Lancer				"Bug Lancer VTOL"
V-Bug-HPV				"Bug HPV VTOL"
V-Scor-Lancer				"Scorpion Lancer VTOL"
V-Scor-HPV				"Scorpion HPV VTOL"
V-Mantis-Lancer				"Mantis Lancer VTOL"
V-Mantis-HPV				"Mantis HPV VTOL"
A-Rep-Cobra-Trk				"Cobra Repair Trucks"
A-Rep-Mantis-Trk			"Mantis Repair Trucks"
ConstrDroidHov				"Hover Constructor"
SK-Viper-Hover-MG			"SK-Viper-Hover-MG"
SK-Viper-Hover-HMG			"SK-Viper-Hover-HMG"
Sk-Viper-Hover-Lcan			"Sk-Viper-Hover-Lcannon"
Sk-Cobra-Hover-Mcan			"Sk-Cobra-Hover-Mcannon"
Sk-Cobra-Hover-MRLS			"Sk-Cobra-Hover-MRLS"
Sk-Python-Hover-Mcn			"Sk-Python-Hover-Mcannon"
Sk-Bug-Hover-Lcan			"Sk-Bug-Hover-Lcannon"
SK-Skorp-Hover-Lc			"SK-Skorp-Hover-Lancer"
Sk-Skorp-Hover-Mcan			"Sk-Skorp-Hover-Mcannon"
Sk-Bug-Vtol-cannon			"Sk-Bug-Vtol-cannon"
Sk-Cobra-Vtol-cannon			"Sk-Cobra-Vtol-cannon"
Sk-Cobra-Vtol-Lancer			"Sk-Cobra-Vtol-Lancer"
Sk-Leopard-Vtol-HVC			"Sk-Leopard-Vtol-HVC"
Sk-Panther-Vtol-HVC			"Sk-Panther-Vtol-HVC"
Sk-Ret-Vtol-plas			"Sk-Ret-Vtol-plasmite"
CobraHRepairHover			"Cobra Hover Heavy-Repair"
ViperHMGWheels				"Viper HMG Wheels"
Scourge-Mantis-H			"Scourge Mantis Hover"
TK-Mantis-H				"TK Mantis Hover"
CobraHMGTracks				"Cobra HMG Tracks"
Cobra-Hover-HC				"Cobra Hover HC"
H-Scorp-Trk-Lancer			"Scorpion Lancer Tracks"
H-Scorp-Trk-HC				"Scorpion Heavy Cannon Tracks"
H-Scorp-VTOL-Lancer			"Scorpion Lancer VTOL"
H-Scorp-VTOL-BB				"Scorpion BB VTOL"
Viper-Trk-Com				"Viper Command Turret Tracks"
Cobra-Trk-Com				"Cobra Command Turret Tracks"
Scorp-Trk-Com				"Scorpion Command Turret Tracks"
Mantis-Trk-Com				"mantis Command Turret Tracks"
CobraTrkLancer				"Cobra Lancer Tracks"
MantisTrkHC				"Mantis Heavy Cannon Tracks"
MantisTKTracks				"Mantis Tank Killer Tracks"
MantisScourgeTracks			"Mantis Scourge Tracks"
ScorpTrkHMG				"Scorpion Heavy Machinegun Tracks"
ScorpRepairTrk				"Scorpion Repair Tracks"
ScorpHRepairHover			"Scorpion Heavy Repair Hover"
CobraHoverTruck				"Cobra Hover Truck"
ScorpHoverTruck				"Scorpion Hover Truck"
MantisHoverTruck			"Mantis Hover Truck"
CobraBBTracks				"Cobra Bunker Buster Tracks"
ScorpBBTracks				"Scorpion Bunker Buster Tracks"
MantisBBTracks				"Mantis Bunker Buster Tracks"
ViperTrkLancer				"Viper Tracks Lancer"
CobraPODHTracks				"Cobra Half-Tracks Mini-Pod"
CobraPODTracks				"Cobra Tracks Mini-Pod"
CobraMRLTracks				"Cobra Tracks Mini-Rocket Artillery"
CobraInfernoHTracks			"Cobra Inferno Half-track"
PythonHoverHVC				"Python HVC Hover"
PythonScourgeTracks			"Python Scourge Tracks"
PythonGaussTracks			"Python Gauss Cannon Tracks"
PythonPulseTracks			"Python Pulse Laser Tracks"
TigerPulseTracks			"Tiger Pulse Laser Tracks"
TigerHvLaserTracks			"Tiger Heavy Laser Tracks"
WyvernGaussTracks			"Wyvern Gauss Cannon Tracks"
WyvernPulseTracks			"Wyvern Pulse Laser Tracks"
WyvernHvLaserTracks			"Wyvern Heavy Laser Tracks"
ViperLtMGHalfTracks			"Viper Machinegun Half-Track"
ViperFlameHalfTracks		"Viper Flamer Half-Track"
PythonTKTracks				"Tank Killer Python Tracks"
PythonMedCanTracks			"Medium Cannon Python Tracks"

//Added for DyDo-AI
CobraInfernoHover			"Inferno Cobra Hover"
CobraMedCnHTrks			  "Medium Cannon Cobra Half Track"
PythonHoverInferno		"Inferno Python Hover"
PhytonHoverAssGun     "Assault Gun Python Hover"
PhytonHTrackAssGun    "Assault Gun Python Half Track"
ScorpHTrackHMG			  "Heavy Machinegun Scorpion Half Tracks"
MantisHoverAC         "Assault Cannon Mantis Hover"
LeopardHoverPulseLas  "Pulse Laser Leopard Hover"
PantherHoverPulseLas  "Pulse Laser Panther Hover"
TigerHoverRailGun     "Rail Gun Tiger Hover"
TigerHoverPulseLas  	"Pulse Laser Tiger Hover"
WyvernPlasmaCTracks  	"Plasma Cannon Wyvern Tracks"
WyvernScourgeTracks  	"Scourge Missile Wyvern Tracks"
RetreHoverFlashLight  "Flashlight Retribution Hover"
ViperPODHalfTracks    "Mini-Rocket Viper Half Track"
ViperMRLHalfTracks    "Mini-Rocket Array Viper Half Track"
SK-Mantis-VTOL-PBB    "Phosphor Bomb Bay Mantis VTOL"
SK-Mantis-VTOL-HBB    "Heap Bomb Bay Mantis VTOL"
SK-Retre-VTOL-HBB     "Heap Bomb Bay Retribution VTOL"
SK-Retal-VTOL-Scourge "Scourge Retaliation VTOL"
SK-Retre-VTOL-Plasmite	"Plasmite Retribution VTOL"
MP-SuperTransport		"Super Transport"

// Additional Campain Strings
ADVANCEDRESEARCH				"ADVANCED RESEARCH"
CAM1VEHICLES				"CAM1 VEHICLES"
CAM2RESEARCH				"CAM2 RESEARCH"
CAM2VEHICLES				"CAM2 VEHICLES"
CAM2CYBORGS					"CAM2 CYBORGS"
CAM2WEAPONS					"CAM2 WEAPONS"
CAM2SYSTEMS					"CAM2 SYSTEMS"
CAM2DEFENSES				"CAM2 DEFENSES"
CAM2STRUCTURES				"CAM2 STRUCTURES"
CAM3RESEARCH				"CAM3 RESEARCH"
